!!!!!!!!!!!!!!!!!!!!
!!!!!!!!!!!!!!!!!!!!
!!!!!!!!!!!!!!!!!!!!
!!!!!!!!!!!!!!!!!!!!
~~~~~~~~~~~~~~~~~~~~
3!!!!!!!!!!!!!!!!!!0
3P!!!!!!!!!!!!!!!!!0
~~~~~~~~~~~~~~~~~~~~
!!!!!!!!!!!!!!!!!!!!
!!!!!!!!!!!!!!!!!!!!
!!!!!!!!!!!!!!!!!!!!
!!!!!!!!!!!!!!!!!!!!
